NO ./textures/visual/beyond_matrix.png
SO ./textures/visual/beyond_matrix.png
WE ./textures/visual/beyond_matrix.png
EA ./textures/visual/beyond_matrix.png

F 248,248,248
C 248,248,248

11111111111111111111
1N000000000000000001
10111111111111111101
10111111111111111101
10111111111111111101
10111111111111111101
10111111111111111101
10111111111111111101
10111111111111111101
10111111111111111101
10111111111111111101
10000000000000000001
11111111111111111111
